"a" = (/turf/template_noop,/area/template_noop)
"b" = (/obj/machinery/door/poddoor{id = "kraken_cargo"},/obj/structure/fans/tiny,/turf/open/floor/plating,/area/template_noop)
"c" = (/obj/item/paper_bin{pixel_x = 6; pixel_y = 4},/obj/structure/table/wood/fancy/royalblack,/obj/item/pen{pixel_x = 6; pixel_y = 5},/turf/open/floor/plasteel/tech,/area/template_noop)
"d" = (/obj/structure/table/reinforced,/obj/effect/turf_decal/siding/dark_red,/obj/effect/turf_decal/siding/dark_red/corner{dir = 1},/obj/item/megaphone/sec{name = "syndicate megaphone"},/turf/open/floor/mineral/plastitanium,/area/template_noop)
"e" = (/obj/item/toy/plush/moth/royal,/turf/template_noop,/area/template_noop)
"f" = (/obj/machinery/door/firedoor/heavy,/turf/open/floor/plasteel/tech/grid,/area/template_noop)
"g" = (/obj/effect/turf_decal/siding/dark_red{dir = 8},/obj/machinery/computer/locator{dir = 8},/turf/open/floor/mineral/plastitanium,/area/template_noop)
"h" = (/obj/structure/curtain/bounty,/obj/structure/bed,/turf/open/floor/carpet/red,/area/template_noop)
"i" = (/turf/closed/wall/mineral/plastitanium,/area/template_noop)
"j" = (/obj/machinery/mineral/processing_unit_console,/turf/closed/wall/mineral/plastitanium/nodiagonal,/area/template_noop)
"k" = (/obj/machinery/atmospherics/components/unary/vent_scrubber/on/layer4,/turf/open/floor/plasteel/tech/grid,/area/template_noop)
"l" = (/obj/machinery/airalarm/directional/north,/obj/item/kirbyplants/photosynthetic,/turf/open/floor/plasteel/tech,/area/template_noop)
"m" = (/obj/machinery/door/airlock/hatch,/obj/machinery/door/firedoor/heavy,/obj/machinery/atmospherics/pipe/simple/scrubbers/hidden/layer4{dir = 8},/turf/open/floor/plasteel/tech,/area/template_noop)
"n" = (/obj/machinery/atmospherics/components/unary/vent_scrubber/on/layer4,/turf/open/floor/mineral/plastitanium,/area/template_noop)
"o" = (/obj/machinery/atmospherics/pipe/simple/scrubbers/hidden/layer4,/turf/open/floor/mineral/plastitanium/red,/area/template_noop)
"p" = (/obj/effect/spawner/structure/window/plastitanium,/turf/open/floor/plating,/area/template_noop)
"q" = (/obj/structure/closet/secure_closet{icon_state = "hos"; name = "\proper captain's locker"; req_access_txt = "20"},/obj/item/clothing/suit/armor/hos,/obj/item/clothing/suit/armor/vest/corporate,/obj/item/clothing/suit/armor/vest/capcarapace/syndicate,/obj/item/clothing/under/syndicate/sniper,/obj/item/clothing/under/rank/security/head_of_security/alt/skirt{name = "syndicate captain's turtleneck skirt"},/obj/item/clothing/under/rank/security/head_of_security/alt{name = "syndicate captain's turtleneck"},/obj/item/clothing/head/HoS/beret/syndicate,/obj/item/clothing/head/HoS/syndicate,/obj/item/clothing/gloves/combat,/obj/item/clothing/glasses/sunglasses/advanced/garb,/obj/item/melee/transforming/energy/sword/saber/red,/obj/item/radio/headset/heads/captain/alt{icon_state = "syndie_headset"},/turf/open/floor/carpet/red,/area/template_noop)
"r" = (/obj/machinery/atmospherics/pipe/simple/scrubbers/hidden/layer4{dir = 8},/turf/open/floor/plasteel/tech,/area/template_noop)
"s" = (/obj/structure/table/reinforced,/obj/effect/turf_decal/siding/dark_red/end{dir = 8},/obj/item/hand_labeler,/turf/open/floor/mineral/plastitanium,/area/template_noop)
"t" = (/obj/machinery/atmospherics/pipe/manifold/scrubbers/hidden/layer4,/turf/open/floor/mineral/plastitanium,/area/template_noop)
"u" = (/obj/machinery/suit_storage_unit/syndicate{helmet_type = /obj/item/clothing/head/helmet/space/syndicate/blue; suit_type = /obj/item/clothing/suit/space/syndicate/blue},/obj/effect/turf_decal/stripes/red/line,/obj/effect/turf_decal/stripes/red/line{dir = 1},/turf/open/floor/plasteel/tech/grid,/area/template_noop)
"v" = (/obj/machinery/firealarm/directional/south,/turf/open/floor/plasteel/tech/grid,/area/template_noop)
"w" = (/obj/machinery/atmospherics/components/unary/vent_pump/on/layer2{dir = 8},/turf/open/floor/plasteel/tech,/area/template_noop)
"x" = (/obj/machinery/atmospherics/pipe/simple/scrubbers/hidden/layer4{dir = 9},/turf/open/floor/plasteel/tech,/area/template_noop)
"y" = (/obj/machinery/shuttle_weapon/point_defense,/turf/closed/wall/mineral/plastitanium/nodiagonal,/area/template_noop)
"z" = (/obj/effect/turf_decal/stripes/red/end{dir = 4},/obj/effect/spawner/structure/window/hollow/reinforced/directional{dir = 8},/turf/open/floor/plasteel/tech/grid,/area/template_noop)
"A" = (/obj/structure/chair/fancy/corp{dir = 4},/turf/open/floor/mineral/plastitanium/red,/area/template_noop)
"B" = (/obj/effect/turf_decal/siding/dark_red/end{dir = 8},/obj/structure/table/reinforced,/obj/item/radio/intercom,/turf/open/floor/mineral/plastitanium,/area/template_noop)
"C" = (/obj/item/phone,/obj/item/melee/chainofcommand,/obj/structure/table/wood/fancy/royalblack,/turf/open/floor/plasteel/tech,/area/template_noop)
"E" = (/obj/machinery/atmospherics/pipe/simple/scrubbers/hidden/layer4{dir = 8},/turf/open/floor/mineral/plastitanium/red,/area/template_noop)
"F" = (/turf/open/floor/mineral/plastitanium/red/airless,/area/template_noop)
"G" = (/turf/open/floor/plasteel/tech,/area/template_noop)
"H" = (/obj/machinery/atmospherics/pipe/simple/scrubbers/hidden/layer4,/turf/open/floor/plasteel/tech,/area/template_noop)
"I" = (/obj/machinery/firealarm/directional/south,/obj/machinery/atmospherics/components/unary/vent_scrubber/on/layer4{dir = 4},/turf/open/floor/plasteel/tech,/area/template_noop)
"J" = (/obj/machinery/vending/boozeomat/pubby_captain,/turf/closed/wall/mineral/plastitanium/nodiagonal,/area/template_noop)
"K" = (/turf/closed/wall/mineral/plastitanium/nodiagonal,/area/template_noop)
"L" = (/obj/machinery/door/firedoor/heavy,/obj/machinery/atmospherics/pipe/simple/scrubbers/hidden/layer4{dir = 8},/turf/open/floor/plasteel/tech/grid,/area/template_noop)
"M" = (/obj/machinery/computer/weapons{dir = 8},/obj/effect/turf_decal/siding/dark_red{dir = 1},/obj/effect/turf_decal/siding/dark_red/corner{dir = 8},/turf/open/floor/mineral/plastitanium,/area/template_noop)
"N" = (/obj/machinery/atmospherics/pipe/simple/scrubbers/hidden/layer4{dir = 8},/turf/open/floor/mineral/plastitanium,/area/template_noop)
"O" = (/obj/effect/landmark/start/captain,/turf/open/floor/carpet/red,/area/template_noop)
"P" = (/obj/machinery/button/door{id = "kraken_cargo"; name = "Cargo Door Controls"},/turf/closed/wall/mineral/plastitanium/nodiagonal,/area/template_noop)
"Q" = (/obj/machinery/mineral/processing_unit{input_dir = 4},/turf/open/floor/plasteel/tech,/area/template_noop)
"R" = (/obj/machinery/airalarm/directional/east,/obj/structure/filingcabinet/chestdrawer,/turf/open/floor/plasteel/tech,/area/template_noop)
"S" = (/turf/open/floor/plasteel/tech/grid,/area/template_noop)
"T" = (/turf/open/floor/mineral/plastitanium/red,/area/template_noop)
"U" = (/obj/machinery/atmospherics/pipe/manifold/scrubbers/hidden/layer4,/turf/open/floor/plasteel/tech,/area/template_noop)
"V" = (/obj/machinery/atmospherics/pipe/simple/scrubbers/hidden/layer4{dir = 10},/turf/open/floor/mineral/plastitanium/red,/area/template_noop)
"W" = (/obj/effect/turf_decal/siding/dark_red{dir = 8},/obj/machinery/computer/shuttle_flight{dir = 8},/turf/open/floor/mineral/plastitanium,/area/template_noop)
"X" = (/obj/machinery/shuttle_weapon/railgun,/turf/closed/wall/mineral/plastitanium/nodiagonal,/area/template_noop)
"Y" = (/turf/open/floor/carpet/red,/area/template_noop)
"Z" = (/turf/open/floor/mineral/plastitanium,/area/template_noop)

(1,1,1) = {"
aaaaaaaaaaaaaaaaaaaaaaaaaaaaaaaaaaa
aaaaaaaaaaaaaaaaaaaaaaaaaaaaaaaaaaa
aaaaaaaaaaaaaaaaaaaaaaaaaaaaaaaaaaa
aaaaaaaaaaaaaaaaaaaaaaaaaaaaaaaaaaa
aaaaaaaaaaaaaaaaaaaaaaaaaaaaaaaaaaa
aaaaaaaaaaaaaaaaaaaaaaaaaaaaaaaaaaa
aaaaaaaaaaaaaaaaaaaaaaaaaaaaaaaaaaa
aaaaaaaaaaaaaaaaaaaaaaaaaaaaaaaaaaa
aaaaaaaaaaaaaaKaaaaaaaaaaaaFFaaeaaa
aaaaaaaaaaaaaaKKKppKyKpppKKKiFFaaaa
aaaaaaaaaaaaaajQGGGGKlGBMKqhKppiFaa
aaaaaaaaaaaaaafZZZnZfTTAgKOYJCcKKia
aaaaaaaaaaaaaafZZNtNLEVAWKSkSSSuzXF
aaaaaaaaaaaaaafZZZZZfTosdKGHvwRKKia
aaaaaaaaaaaaaaKGGGGGKIUrrmrxKppiFaa
aaaaaaaaaaaaaaKKbbbPyKpppKKKiFFaaaa
aaaaaaaaaaaaaaKaaaaaaaaaaaaFFaaaaaa
aaaaaaaaaaaaaaaaaaaaaaaaaaaaaaaaaaa
aaaaaaaaaaaaaaaaaaaaaaaaaaaaaaaaaaa
aaaaaaaaaaaaaaaaaaaaaaaaaaaaaaaaaaa
aaaaaaaaaaaaaaaaaaaaaaaaaaaaaaaaaaa
aaaaaaaaaaaaaaaaaaaaaaaaaaaaaaaaaaa
aaaaaaaaaaaaaaaaaaaaaaaaaaaaaaaaaaa
aaaaaaaaaaaaaaaaaaaaaaaaaaaaaaaaaaa
aaaaaaaaaaaaaaaaaaaaaaaaaaaaaaaaaaa
"}
